20 15
11111111111111111111
1111W111111111111111
S111W111111111111111
1111W111WWWWWWWWW111
1111W111W11111111111
1111W111W11111111111
1111W111W1F111111111
1111W111W11111111111
1111W111111111111111
1111W111W11111111111
1111W111W11111111111
1111W111W11111111111
1111W111W11111111111
11111111111111111111
11111111111111111111