10 10
11119F1111
1S11911111
1111911111
1111911111
1111111111
1111111111
1111111111
1111111111
1111111111
1111111111